维护者：1339088820@qq.com
版本号：1.5.4
更新时间：2025-10-11

词条
//区分大小写
Dimitri Alexandre Blaiddyd=帝弥托利·亚历山大·布雷达德
Dedue Molinaro=杜笃·莫利纳洛
Felix Hugo Fraldarius=菲力克斯·尤果·伏拉鲁达力乌斯
Mercedes von Martritz=梅尔赛德司·冯·马尔特利兹
Ingrid Brandl Galatea=英谷莉特·布兰多尔·贾拉提雅
Sylvain Jose Gautier=希尔凡·乔瑟·戈迪耶
Annette Fantine Dominic=雅妮特·方提努·多米尼克
Ashe Ubert=亚修·多蓝
Edelgard von Hresvelg=艾黛尔贾特·冯·弗雷斯贝尔古
Hubert von Vestra=修伯特·冯·贝斯特拉
Bernadetta von Varley=贝尔娜提塔·冯·瓦立
Dorothea Arnault=多洛缇雅·雅尔诺尔德
Ferdinand von Aegir=菲尔迪南特·冯·艾吉尔
Caspar von Bergliez=卡斯帕尔·冯·贝尔谷里斯
Petra Macneary=佩托拉·马克聂阿利
Linhardt von Hevring=林哈尔特·冯·海弗林格
Claude von Riegan=库罗德·冯·里刚
Hilda Valentine Goneril=希尔妲·凡伦汀·哥纳利尔
Lysithea von Ordelia=莉丝缇亚·冯·科迪利亚
Marianne von Edmund=玛莉安奴·冯·艾德蒙
Leonie Pinelli=雷欧妮·皮聂利
Ignatz Victor=伊古纳兹·维克特
Raphael Kirsten=拉斐尔·克里斯汀
Lorenz Hellman Gloucester=洛廉兹·海尔曼·古罗斯塔尔
Yuri Leclerc=尤里斯·路克雷
Constance von Nuvelle=康丝坦洁·冯·努维尔
Hapi=哈琵
Balthus von Albrecht=巴鲁塔札尔·冯·亚达尔布雷希特
Rhea=蕾雅
Seteth=西提司
Byleth=贝雷丝
Manuela Casagranda=玛努艾拉·卡扎古蓝达
Hanneman von Essar=汉尼曼·冯·艾萨
Jeritza von Hrym=伊艾里扎·冯·弗琉慕
Tomas=托马修
Flayn=芙莲
Jeralt Reus Eisner=杰拉尔特·罗伊斯·艾斯纳
Aelfric Dahlman=阿尔法卢特·达尔曼
Cyril=锥里尔
Alois Rangeld=阿罗伊斯·兰贾尔特
Catherine=卡多莉奴
Sothis=苏谛斯
Ladislava=拉蒂丝拉瓦
Emperor Ionius IX=伊欧尼亚斯九世
Lord Arundel=亚兰德尔公
Flame Emperor=炎帝
Reaper Knight=死神骑士
Kronya=科萝妮艾
Sitri Eisner=希特莉·艾斯纳
Randolph von Bergliez=兰道夫·冯·贝尔谷里斯
Fleche von Bergliez=芙蕾伽·冯·贝尔谷里斯
Metodey=梅特杰
Duke Gerth=盖尔兹公爵
Baron Ochs=奥克斯男爵
Monica von Ochs=莫妮卡·冯·奥克斯
Patricia=帕特丽西雅
Anselma=安萨尔玛
Duke Aegir=艾吉尔公爵
Lambert Egitte Blaiddyd=蓝贝尔·艾吉特·布雷达德
Rodrigue Achille Fraldarius=罗德利古·亚希尔·伏拉鲁达力乌斯
Rufus Thierry Blaiddyd=琉法司·迪耶利·布雷达德
Grand Duke of Itha=伊哈大公
Cornelia Arnim=科尔娜莉亚·阿尔尼姆
Gwendal Roche=关达尔·罗殊
Lonato Gildas Gaspard=罗纳特·吉尔达·盖斯巴尔
Miklan Anschutz Gautier=迈克朗·安修兹·戈迪耶
Glenn Govan Fraldarius=古廉·高凡·伏拉鲁达力乌斯
Gilbert Pronislav=吉尔伯特·普罗尼斯拉夫
Judith von Daphnel=朱迪特·冯·达夫纳尔
Holst Sigiswald Goneril=荷尔斯特·基吉斯瓦尔特·哥纳利尔
Acheron Lethe Phlegethon=阿肯隆·雷特·弗雷格顿
Shamir=萨米亚
Tiana=缇雅纳
Nader=纳戴尔
Indech=印迪哈
Macuil=玛库伊尔
Fódlan=芙朵拉
Garreg Mach Monastery=加尔古·玛库大修道院
Garreg Mach Officers Academy=加尔古·玛库士官学校
Children of the Goddess=女神眷属
Divine Pulse=天刻之脉动
Insurrection of the Seven=七贵族之变
Tragedy of Duscur=达斯卡悲剧
10 Elites=十杰
The Progenitor God=创世女神
Crest=纹章
Hero's Relics=英雄的遗产
Dima=迪玛
Fe=菲
Areadbhar=阿莱德巴尔


通用词条

//不区分大小写
Holy Kingdom of Faerghus=法嘉斯神圣王国
Fraldarius=伏拉鲁达力乌斯
Adrestian Empire=阿德剌斯忒亚帝国
Leicester Alliance=雷斯塔诸侯同盟
Brigid=布里基特
Dagda=鞑古扎
Albinea=阿鲁比聂
Sreng=斯灵
Church of Seiros=赛罗司教会
Knights of Seiros=赛罗司骑士团
Blue Lions House=青狮子学级
Black Eagles House=黑鹫学级
Golden Deer House=金鹿学级
Ashen Wolves House=灰狼学级
Jeralt's Mercenaries=杰拉尔特佣兵团
Liberation King=解放王
The Cathedral=大教堂
The Holy Tomb=圣墓
Goddess Tower=女神之塔
Knights' Hall=骑士之间
Training Grounds=训练场
Seminar=课题
Cavalier=骑士
Pegasus Knight=飞马骑士
Armored Knight=重装骑士
Mortal Savant=墓志铭
Paladin=神圣骑士
Wyvern Rider=飞龙骑士
fe=菲
Areadbhar=阿莱德巴尔

































































































